. . . . . . . . . . . . . . . . . . . . . . . . . . . . . . . . . . . . . . . . . . . . # # # # # # #
. . . . . . . . . . . . . . . . . . . . . . . . . . . . . . . . . . . . . . . . . . . . # . . . . . #
. . . . . . . . . . . . . . . . . . . . . . . . . . . . . . . . . . . . . . . . . . . . # . . . . . #
. . . . . . . . . . . . . . . . . . . . . . . . . . . . . . . . . . . . . . . . . . . . # . . . . . #
. . . . . . . . . . . . . . . . . . . . . . . . . . . . . . . . . . . . . . . . . . . . # . . . . . #
. . . . . . . . . . . . . . . . . . . . . . . . . . . . . . . . . . . . . . . . . . . . # . . . . . #
. . . . . . . . . . . . . . . . . . . . . . . . . . . . . . . . . . . . . . . . # # # # # # # # # # #
. . . . . . . . . . . . . . . . . . . . . . . . . . . . . . . . . . . . . . . . # . . . # . . . . . .
. . . . . . . . . . . . . . . . . . . . . . . . . . . . . . . . . . . . # # # # # # # # # . . . . . .
. . . . . . . . . . . . . . . . . . . . . . . . . . . . . . . . . . . . # . . . # . . . . . . . . . .
. . . . . . . . . . . . . . . . . . . . . . . . . . . . . . . . . . # # # # # # # # # . . . . . . . .
. . . . . . . . . . . . . . . . . . . . . . . . . . . . . . . . . . # . # . . . # . # . . . . . . . .
. . . . . . . . . . . . . . . . . . . . . . . . . . . . . . . . . . # . # . . . # . # . . . . . . . .
. . . . . . . . . . . . . . . . . . . . . . . . . . . . . . . . . . # . # . . . # . # . . . . . . . .
. . . . . . . . . . . . . . . . . . . . . . . . . . . . . . . . . . # . # . . . # # # # # # # # # . .
. . . . . . . . . . . . . . . . . . . . . . . . . . . . . . . . . . # . # . . . . . # . . . . . # . .
. . . . . . . . . . . . . . . . . . . . . . . . . . # # # # # # # # # # # . . . . . # . . . . . # . .
. . . . . . . . . . . . . . . . . . . . . . . . . . # . . . . . . . # . . . . . . . # . . . . . # . .
. . . . . . . . . . . . . . . . . . . . . . . . # # # # # # # # # # # . . . . . . . # . . . . . # . .
. . . . . . . . . . . . . . . . . . . . . . . . # . # . . . . . . . . . . . . . . . # . . . . . # . .
. . . . . . . . . . . . . . . . . . . . . . . . # . # . . . . . . . . . . . . . . . # # # # # # # . .
. . . . . . . . . . . . . . . . . . . . . . . . # . # . . . . . . . . . . . . . . . . . . . . . . . .
. . . . . . . . . . . . . . # # # # # # # # # . # . # . . . . . . . . . . . . . . . . . . . . . . . .
. . . . . . . . . . . . . . # . . . . . . . # . # . # . . . . . . . . . . . . . . . . . . . . . . . .
# # # # # # # . . . . . . . # . . . # # # # # # # # # . . . . . . . . . . . . . . . . . . . . . . . .
# . . . . . # . . . . . . . # . . . # . . . # . # . . . . . . . . . . . . . . . . . . . . . . . . . .
# . . . . . # . . . . . . . # . # # # # # # # # # . . . . . . . . . . . . . . . . . . . . . . . . . .
# . . . . . # . . . . . . . # . # . # . . . # . . . . . . . . . . . . . . . . . . . . . . . . . . . .
# . . . . . # . . . . . . . # . # . # . . . # . . . . . . . . . . . . . . . . . . . . . . . . . . . .
# . . . . . # . . . . . . . # . # . # . . . # . . . . . . . . . . . . . . . . . . . . . . . . . . . .
# # # # # # # # # . . . . . # . # . # . . . # # # # # # # # # # # # # . . . . . . . . . . . . . . . .
. . . . . . # . # . . . . . # . # . # . . . . . . . . . . . . . . . # . . . . . . . . . . . . . . . .
. . . . . . # . # . . . . . # . # . # # # # # # # # # # # # # . . . # . . . . . . . . . . . . . . . .
. . . . . . # . # . . . . . # . # . . . . . . . . . . . . . # . . . # . . . . . . . . . . . . . . . .
. . . . . . # # # # # # # # # . # . . . . . . . . . . . . . # . . . # . . . . . . . . . . . . . . . .
. . . . . . . . # . . . . . . . # . . . . . . . . . . . . . # . . . # . . . . . . . . . . . . . . . .
. . . . . . . . # . . . . . . . # . . . . . . . . . . . . . # . . . # . . . . . . . . . . . . . . . .
. . . . . . . . # . . . . . . . # . . . . . . . . . . . . . # . . . # . . . . . . . . . . . . . . . .
. . . . . . . . # # # # # # # # # . . . . . . . . . # # # # # # # # # . . . . . . . . . . . . . . . .
. . . . . . . . . . . . . . . . . . . . . . . . . . . . . . # . . . . . . . . . . . . . . . . . . . .
. . . . . . . . . . . . . . . . . . . . . . . . . . . . . . # # # # # # # # # . . . . . . . . . . . .
. . . . . . . . . . . . . . . . . . . . . . . . . . . . . . . . . . . . . . # . . . . . . . . . . . .
. . . . . . . . . . . . . . . . . . . . . . . . . . . . . . . . . . . . . . # . . . . . . . . . . . .
. . . . . . . . . . . . . . . . . . . . . . . . . . . . . . . . . . . . . . # . . . . . . . . . . . .
. . . . . . . . . . . . . . . . . . . . . . . . . . . . . . . . . . . . . . # . . . . . . . . . . . .
. . . . . . . . . . . . . . . . . . . . . . . . . . . . . . . . . . . . . . # . . . . . . . . . . . .
. . . . . . . . . . . . . . . . . . . . . . . . . . . . . . . . . . . . . . # . . . . . . . . . . . .
. . . . . . . . . . . . . . . . . . . . . . . . . . . . . . . . . . . . . . # . . . . . . . . . . . .
. . . . . . . . . . . . . . . . . . . . . . . . . . . . . . . . . . . . . . # . . . . . . . . . . . .
. . . . . . . . . . . . . . . . . . . . . . . . . . . . . . . . . . . . . . # . . . . . . . . . . . .
. . . . . . . . . . . . . . . . . . . . . . . . . . . . . . . . . . . . . . # # # # # # # # ^ . . . .
